1111111111
2000000001
1110111011
1011100001
1010101101
1010101101
1000001111
1011011102
1001000001
1111111111