11111111111111111111
10010010101000010021
10111010111111111011
10001000000100000001
11101111110101111101
10000000000000010101
11110111111111111101
10000000000001000001
11111111110111111111
10000000000001011001
11111111110111111111
10000001000000000001
11111111111111111001
10000000000000001001
11111111111111111011
10000000000001000001
11111111111111011111
10000000000000000021
11111111111111111111